ask_temperature	Temperature
ask_weather_temperature	Weather
ask_weather	Weather
weather_search_location	Weather
call_to_someone	Contact
print_typed_number	Contact
add_number	Contact
del_number	Contact
del_typed_number	Contact
print_contact_number	Contact
recieved_message	Message
recieved_name_message	Message
count_message	Message
count_name_message	Message
delete_from_message	Message
delete_from_name_message	Message
delete_message	Message
send_message	Contact
temperature_compare_search_location	Temperature
temperature_min_max_search_location	Temperature